Column_name	Type
index	int
Order_ID	nvarchar
Date	date
Status	nvarchar
Fulfilment	nvarchar
Sales_Channel	nvarchar
ship_service_level	nvarchar
Style	nvarchar
SKU	nvarchar
Category	nvarchar
Size	nvarchar
ASIN	nvarchar
Courier_Status	nvarchar
Qty	tinyint
currency	nvarchar
Amount	float
ship_city	nvarchar
ship_state	nvarchar
ship_postal_code	int
ship_country	nvarchar
B2B	bit
fulfilled_by	nvarchar
